000000000000000000000000000000000000000000000000000000000000
000000000000000000000000000000000000000000000000000000000000
000000000000000000000000000000000000000000000000000000000000
000000000000000000000000000000000000000000000000000000000000
000000000000000000000000000000000000000000000000000000000000
000000000000000000000000000000000000000000000000000000000000
000000000000000000000000000000000000000000000000000000000000
000000000000000000000000000000000000000000000000000000000000
000000000111111111111111111111311111111111111111111000000000
000000000100000000000000000001010000000000000000001000000000
000000000101111111111111111101011111101111111111101000000000
000000000101000000000010000101000000100000000000101000000000
000000000101011111111010000001111110111111111110101000000000
000000000101010000001010111111000000000000000010101000000000
000000000101010111101010100001011111111011111010101000000000
000000000101010100101010101111110000000010000010101000000000
000000000101010100101010101000001111111011111110101000000000
000000000101010100101010101011101000000000000000101000000000
000000000101011101111010101010101111111111111111101000000000
000000000101000001000010100010000000000000000000001000000000
000000000101111101111110101110111111111111111111111000000000
000000000100000100000000100100000000000000000000001000000000
000000000111110111111111100101111110111111111111101000000000
000000000100000000000000100101000000100000000000101000000000
000000000101111111110110100101011111111111111110101000000000
000000000100000000010100100101010000000000000000101000000000
000000000101111111010111100101010010111111111111101000000000
000000000101010101010000000001011011100000000000001000000000
000000000101010101011111111101001000001111111111111000000000
000000000101010101000001000001101111111000000000001000000000
000000000101010101111101011111001000001011111111101000000000
000000000101010000000001010000001011101000000000101000000000
000000000101010100000101010111111010101111111110101000000000
000000000101010100000101010100000010101000000000101000000000
000000000101010100000101010001111110101011111111101000000000
000000000101010100000101011111001000101000000000101000000000
000000000101010111111101000000000010101111111110101000000000
000000000101010000000101011111110010101000000000101000000000
000000000101011111110101000000011110101110111111101000000000
000000000101000000000101011111010000101010100000101000000000
000000000101011111111101010001010111101010101110101000000000
000000000100000000000001010101010000001010101210101000000000
000000000101111111111111010101010111111010101010101000000000
000000000100000000000000000101010100000010101010101000000000
000000000101011111111111111101010101111010101010101000000000
000000000101010000000000000000010101001010101010101000000000
000000000101010000000000000000010001001010101000101000000000
000000000101011111111111111111111111001010101111101000000000
000000000101000000000000000000000000001010001000101000000000
000000000101111111111111111111111111101011111010101000000000
000000000100000000000000000000000000001000000010001000000000
000000000111111111111111111111111111111111111111111000000000
000000000000000000000000000000000000000000000000000000000000
000000000000000000000000000000000000000000000000000000000000
000000000000000000000000000000000000000000000000000000000000
000000000000000000000000000000000000000000000000000000000000
000000000000000000000000000000000000000000000000000000000000
000000000000000000000000000000000000000000000000000000000000
000000000000000000000000000000000000000000000000000000000000
000000000000000000000000000000000000000000000000000000000000
000000000000000000000000000000000000000000000000000000000000

